[contrail_api_cli.clean]
clean-fqn = contrail_api_cli_extra.clean.fqn:CleanFQN
clean-mandatory = contrail_api_cli_extra.clean.clean_obj_mandatory_fields:CleanObjMandatoryFields
clean-orphaned-acl = contrail_api_cli_extra.clean.orphaned_acl:OrphanedACL
clean-refs = contrail_api_cli_extra.clean.refs:CleanRefs
clean-route-target = contrail_api_cli_extra.clean.rt:CleanRT
clean-si-scheduling = contrail_api_cli_extra.clean.si:CleanSIScheduling
clean-stale-si = contrail_api_cli_extra.clean.si:CleanStaleSI
clean-subnet = contrail_api_cli_extra.clean.subnet:CleanSubnet
purge-project = contrail_api_cli_extra.clean.project:PurgeProject

[contrail_api_cli.command]
apply-sg = contrail_api_cli_extra.misc.apply_sg:ApplySG
check-bad-refs = contrail_api_cli_extra.misc.check_bad_refs:CheckBadRefs
dot = contrail_api_cli_extra.misc.dot:Dot
find-orphaned-projects = contrail_api_cli_extra.clean.project:FindOrphanedProjects
fix-fip-locks = contrail_api_cli_extra.fix.fix_fip_locks:FixFIPLocks
fix-ri = contrail_api_cli_extra.fix.ri:FixRI
fix-sg = contrail_api_cli_extra.fix.fix_sg:FixSg
fix-subnets = contrail_api_cli_extra.fix.fix_subnets:FixSubnets
fix-vn-id = contrail_api_cli_extra.fix.fix_vn_id:FixVnId
fix-zk-ip = contrail_api_cli_extra.fix.fix_zk_ip:FixZkIP
graph = contrail_api_cli_extra.misc.graph:Graph
manage-rt = contrail_api_cli_extra.misc.manage_rt:ManageRT
provision = contrail_api_cli_extra.provision.provision:Provision
reschedule-vm = contrail_api_cli_extra.misc.vm:RescheduleVM
rpf = contrail_api_cli_extra.misc.rpf:RPF

[contrail_api_cli.migration]
migrate-host-routes = contrail_api_cli_extra.migration.host_routes:MigrateHostRoutes
migrate-lb = contrail_api_cli_extra.migration.lb:MigrateLB22132
migrate-rt = contrail_api_cli_extra.migration.rt:MigrateRT22132
migrate-si = contrail_api_cli_extra.migration.si:MigrateSI110221

[contrail_api_cli.provision]
add-analytics = contrail_api_cli_extra.provision.analytics:AddAnalytics
add-bgp-router = contrail_api_cli_extra.provision.bgp_router:AddBGPRouter
add-config = contrail_api_cli_extra.provision.config:AddConfig
add-dns-nameserver = contrail_api_cli_extra.provision.dns_nameserver:AddDNSNameserver
add-linklocal = contrail_api_cli_extra.provision.linklocal:AddLinklocal
add-lr = contrail_api_cli_extra.provision.lr:AddLR
add-sas = contrail_api_cli_extra.provision.service_appliance_set:AddSAS
add-sg = contrail_api_cli_extra.provision.sg:AddSG
add-vn = contrail_api_cli_extra.provision.vn:AddVN
add-vrouter = contrail_api_cli_extra.provision.vrouter:AddVRouter
del-analytics = contrail_api_cli_extra.provision.analytics:DelAnalytics
del-bgp-router = contrail_api_cli_extra.provision.bgp_router:DelBGPRouter
del-config = contrail_api_cli_extra.provision.config:DelConfig
del-dns-nameserver = contrail_api_cli_extra.provision.dns_nameserver:DelDNSNameserver
del-linklocal = contrail_api_cli_extra.provision.linklocal:DelLinklocal
del-lr = contrail_api_cli_extra.provision.lr:DelLR
del-sas = contrail_api_cli_extra.provision.service_appliance_set:DelSAS
del-sg = contrail_api_cli_extra.provision.sg:DelSG
del-vn = contrail_api_cli_extra.provision.vn:DelVN
del-vrouter = contrail_api_cli_extra.provision.vrouter:DelVRouter
get-encaps = contrail_api_cli_extra.provision.encapsulation:GetEncapsulation
get-global-asn = contrail_api_cli_extra.provision.global_asn:GetGlobalASN
get-route-targets = contrail_api_cli_extra.provision.route_target:GetRouteTargets
get-subnets = contrail_api_cli_extra.provision.subnet:GetSubnets
list-analytics = contrail_api_cli_extra.provision.analytics:ListAnalytics
list-bgp-router = contrail_api_cli_extra.provision.bgp_router:ListBGPRouter
list-config = contrail_api_cli_extra.provision.config:ListConfig
list-dns-nameserver = contrail_api_cli_extra.provision.dns_nameserver:ListDNSNameserver
list-linklocal = contrail_api_cli_extra.provision.linklocal:ListLinklocal
list-lr = contrail_api_cli_extra.provision.lr:ListLRs
list-sas = contrail_api_cli_extra.provision.service_appliance_set:ListSAS
list-sg = contrail_api_cli_extra.provision.sg:ListSGs
list-vn = contrail_api_cli_extra.provision.vn:ListVNs
list-vrouter = contrail_api_cli_extra.provision.vrouter:ListVRouter
set-encaps = contrail_api_cli_extra.provision.encapsulation:SetEncapsulation
set-global-asn = contrail_api_cli_extra.provision.global_asn:SetGlobalASN
set-route-targets = contrail_api_cli_extra.provision.route_target:SetRouteTargets
set-subnets = contrail_api_cli_extra.provision.subnet:SetSubnets

